  abcdefghijklmnopqrstuvwxyzABCDEFGHIJKLMN
39........................................
38........................................
37........................................
36....BBBBBBBBBBBBBBBBBBBBBBBBBBBBBBBB....
35....BBBBBBBBBBBBBBBBBBBBBBBBBBBBBBBB....
34....BBBBBBBBBBBBBBBBBBBBBBBBBBBBBBBB....
33....BBBBBBBBBBBBBBBBBBBBBBBBBBBBBBBB....
32....BBBBBBBBBBBBBBBBBBBBBBBBBBBBBBBB....
31....BBBBBBBBBBBBBBBBBBBBBBBBBBBBBBBB....
30....BBBBBBBBBBBBBBBBBBBBBBBBBBBBBBBB....
29....BBBBBBBBBBBBBBBBBBBBBBBBBBBBBBBB....
28........................................
27........................................
26........................................
25........................................
24........................................
23........................................
22........................................
21........................................
20........................................
19........................................
18........................................
17........................................
16........................................
15........................................
14........................................
13........................................
12........................................
11........................................
10........................................
09........................................
08........................................
07........................................
06........................................
05........................................
04........................................
03........................................
02........................................
01........................................
